........
........
........
...S....
..SSSS..
..S..S..
..S..SS.
..S..S..
..SSSS..
........
........
........
........
........
