Square Movement
Brandon Gomez
255,128,128
0.1,0.3,0.5
0,0.05,0.07
0,0,0
--------
--------
--------
--------
--CCCCCC
--CCOCOC
--CCOOCC
--COCCOC
--OCCCCC
--OOOOOC
--CCOCCC
--OOOOOC
--OCCOCO
--OCOCCO
*Different Blues
Brandon Gomez
89,203,209
0.1,0.4,0.5
0,0.1,0
0,0,0
--------
--------
--------
--------
--------
--------
-CCCCC--
-CCCCC--
--------
--------
--------
--------
--------
--------
*Vibrant
Brandon Gomez
255,254,128
0.4,0.4,0.3
-0.2,0,0.1
0,-0.1,0
--------
--------
--------
--------
-CCCCC--
-CCCCC--
-CCCCC--
-CCCCC--
-CCCCC--
--------
--------
--------
--------
--------
*Different Take
Brandon Gomez
192,229,203
0.5,0.4,0.3
0,0,0.1
-0.1,0,0
--------
--------
--------
--------
-CCCCC--
-CCCCC--
-CC-CC--
-CCCCC--
-CCCCC--
--------
--------
--------
--------
--------
*Ramping Up
Brandon Gomez
255,160,127
0.5,0.4,0.4
-0.15,0,0.025
0,0.05,0
--------
--------
--------
--------
-CC-CC--
-CCCCC--
-CCCCC--
-CCCCC--
-CC-CC--
--------
--------
--------
--------
--------
*Space Ship
Brandon Gomez
127,192,254
0.2,0.4,0.5
0.07,0,0
0,0.05,0
--------
--------
--------
--------
----CCC-
--CCCCC-
-CCCC---
-CCCC---
--CCCCC-
----CCC-
--------
--------
--------
--------
*Smile
Brandon Gomez
172,220,201
0.1,0.45,0.45
0.05,0,0.05
0,0.05,0
--------
--------
--------
CCCCCCC-
C-CCC-C-
CCCCCCC-
CCCCCCC-
C-CCC-C-
C-----C-
CCCCCCC-
--------
--------
--------
--------
*Ice Cream Wishes
Brandon Gomez
255,160,160
0.35,0.35,0.35
0,0.1,0.1
0.1,0,0
--------
--------
--------
--------
-CCCCCC-
-C--CCC-
-CCCC-C-
-CCCCCC-
-CC-CCC-
-CC-CCC-
--------
--------
--------
--------
*C
Brandon Gomez
161,254,222
0.2,0.4,0.5
0,0.038,0
0,0,-0.017
--------
--------
--------
--CCCCC-
-CCCCCC-
-CCC-CC-
-CCC----
-CCC----
-CCC—CC-
-CCCCCC-
--CCCCC-
--------
--------
--------
*The Ball
Brandon Gomez
16,0,48
0.25,0.335,0.445
0,0.075,0
0.055,0,-0.05
--------
--------
--------
--CCCC--
-CC--CC-
CCCC--CC
CCCCC--C
CCCCCC-C
CCCCCCCC
-CCCCCC-
--CCCC--
--------
--------
--------
*Abstract
Brandon Gomez
255,192,208
0.3,0.3,0.3
0,0.05,0.025
-0.025,0,0
--------
--------
--------
CCCCCCCC
CCCCCCCC
-CC--CCC
-CC-CCCC
-CCCC-CC
-CCCCCCC
CC----CC
CCCCCCC-
--------
--------
--------
*Universal Language
Brandon Gomez
172,122,155
0.375,0.125,0.25
0,0.025,0.01
0.1,0,0
--------
--------
--------
-CC--CC-
CCCCCCCC
CCCCCCCC
CCCCCCCC
-CCCCCC-
-CCCCCC-
--CCCC-
---CC---
--------
--------
--------
*Hunt for the Path
Brandon Gomez
64,32,48
0.25,0.335,0.4
0,0.1,0.05
0.1,0,0
--------
--------
-CCCCCCC
-CCC-CCC
-CCCCCCC
--CC--C-
--CCCCC-
--C-CCC-
--CCC-C-
-CCCCCCC
-CCC-CCC
-CCCCCCC
--------
--------
*Take This
Brandon Gomez
155,229,219
0.392,0.387,0.453
0,0,0.043
0.036,-0.02,0
---CC---
--CCCC--
--C-CC--
--CCCC--
--CC-C--
--C-CC--
--CCCC--
--CC-C--
--C-CC--
--CCCC--
CCCCCCCC
CCCCCCCC
--CCCC--
--CCCC--
*Red & Blue
Brandon Gomez
234,222,212
0.384,0.276,0.373
-0.056,0,0
0,-0.032,-0.029
CCCCCCCC
C-CCCC-C
CCCCCCCC
CCC--CCC
C-C--C-C
C-C--C-C
C-CCCC-C
C-CCCC-C
C-C--C-C
C-C--C-C
CCC--CCC
CCCCCCCC
C-CCCC-C
CCCCCCCC
*Green & Blue
Brandon Gomez
255,254,160
0.026,0.463,0.430
0,0,-0.014
-0.014,-0.029,0
--------
-CCCCCC-
CC-CC-CC
CCC--CCC
CCC--CCC
CC-CC-CC
CCCCCCCC
CCCCCCCC
CC-CC-CC
CCC--CCC
CCC--CCC
CC-CC-CC
-CCCCCC-
--------